User-agent: *
Sitemap: {{ .Sitemap.Filename | default "sitemap.xml" | absURL }}

######################################################################################
##                     _ _                                                 _     _  ##
##                    | | |                                               (_)   | | ##
##  _ __ _ __ ___   __| | |__  _ __  _ __ ___ ______ _   _ __ ___  _   _   _  __| | ##
## | '__| '_ ` _ \ / _` | '_ \| '_ \| '__/ _ \_  / _` | | '_ ` _ \| | | | | |/ _` | ##
## | |  | | | | | | (_| | | | | | | | | |  __// / (_| |_| | | | | | |_| |_| | (_| | ##
## |_|  |_| |_| |_|\__,_|_| |_|_| |_|_|  \___/___\__,_(_)_| |_| |_|\__, (_)_|\__,_| ##
##                                                                  __/ |           ##
##                                                                 |___/            ##
######################################################################################